10
-.-.-.G.-.-.-.-.-.-
-.W.-.-.-.-.-.-.-.W
-.-.-.HP.-.-.-.-.PG.-
G.-.-.-.-.-.-.W.-.-
-.-.-.G.-.-.-.HP.-.-
-.-.-.-.A.-.-.-.-.-
PG.-.-.-.G.-.-.-.-.-
-.-.-.-.-.-.P.-.-.G
-.-.-.-.-.-.W.-.-.-
-.-.P.-.-.-.-.G.-.W