10
A.-.-.G.-.-.-.-.-.-
-.W.-.-.-.-.-.-.-.W
-.-.-.HP.-.-.-.-.PG.-
G.-.-.-.-.-.W.-.-.-
-.-.-.G.-.-.-.HP.-.-
-.-.-.-.-.-.-.-.-.-
PG.-.-.-.G.-.-.-.-.-
-.-.-.-.-.-.P.-.-.G
-.-.-.-.-.-.W.-.-.-
-.-.P.-.-.-.-.G.-.W