5
A.-.-.-.-
-.W.-.-.P
-.-.-.-.-
G.-.-.-.-
-.-.-.-.-

