10
W.P.-.G.-.-.P.-.-.A
-.P.-.-.-.-.-.-.-.-
-.-.-.G.-.-.-.-.PG.-
G.-.-.-.-.-.-.-.-.-
-.-.-.P.-.-.-.HP.-.P
-.-.-.-.-.-.-.-.-.-
PG.-.-.-.G.-.-.-.-.-
-.-.-.-.-.-.P.-.-.G
-.-.-.-.-.-.W.-.-.-
-.-.P.-.-.-.-.G.-.-