6
A.-.-.-.-.-
-.W.-.-.-.P
-.-.-.-.-.-
G.-.-.-.-.-
-.-.-.P.-.-
-.-.-.-.-.-

