10
W.-.-.G.-.-.-.P.-.A
-.-.P.-.-.-.-.-.-.-
-.-.-.G.-.-.-.-.PG.-
G.-.-.-.-.-.-.-.-.-
-.-.-.-.P.-.-.HP.P.-
-.-.-.-.-.-.-.-.-.-
PG.-.-.-.G.-.-.-.-.-
G.-.-.-.-.-.P.-.-.G
-.-.-.-.-.-.W.-.-.-
W.-.P.-.-.-.-.G.P.-