8
A.-.-.G.-.-.W.-
-.W.-.-.-.P.-.-
-.-.-.HP.-.-.-.-
G.-.-.-.-.-.-.-
-.-.-.-.P.-.P.-
-.-.-.-.-.-.-.-
-.PG.-.-.-.-.G.-
-.-.-.-.-.W.-.-

