10
-.-.-.G.-.-.P.-.-.-
-.W.-.-.-.-.-.-.-.W
-.-.-.HP.-.-.P.-.PG.-
G.-.-.-.-.-.W.-.-.-
-.-.-.G.-.-.-.HP.-.-
-.-.-.-.-.-.-.-.-.-
-.PG.-.-.G.-.-.-.-.-
-.P.-.-.-.-.P.-.-.G
-.-.-.-.-.-.W.-.-.-
A.P.-.-.-.P.-.G.-.W