8
A.-.-.G.-.-.-.-
-.W.-.-.-.P.-.-
-.-.-.-.-.-.-.-
G.-.-.-.-.-.-.-
-.-.-.-.P.-.-.HP
-.-.-.-.-.-.-.-
-.PG.-.-.-.-.-.-
-.-.-.-.-.W.-.-

