10
A.-.-.G.-.-.-.-.-.PG
-.W.-.-.-.P.-.-.-.-
-.-.-.-.-.-.-.-.-.-
G.-.-.-.-.-.-.-.-.-
-.-.-.-.-.P.-.HP.-.-
-.-.-.-.-.-.-.-.-.-
-.PG.-.-.-.-.-.-.-.-
-.-.-.-.-.-.-.-.-.G
-.-.-.-.-.W.-.-.-.-
-.-.-.-.-.-.-.-.-.-

