10
W.-.-.G.-.-.P.-.-.-
-.W.-.-.-.-.-.-.-.W
-.-.-.P.-.-.-.-.PG.-
G.-.-.-.-.-.W.-.-.-
-.-.-.P.-.-.-.HP.-.-
-.-.-.-.-.-.-.-.-.-
HP.PG.-.-.G.-.-.-.-.-
-.-.-.-.-.-.P.-.-.G
-.-.-.-.-.W.-.-.-.-
-.-.P.-.-.-.-.-.-.A
