10
A.-.-.W.-.-.-.-.-.-
-.-.-.W.-.-.-.-.-.-
-.-.-.W.-.-.-.-.-.-
W.W.W.-.-.-.-.-.-.-
-.-.-.-.-.-.-.-.-.-
-.-.-.-.-.-.-.-.-.-
-.-.-.-.-.-.-.-.-.-
-.-.-.-.-.-.-.-.-.-
-.-.-.-.-.-.-.-.-.-
-.-.-.-.-.-.-.-.-.-