10
-.-.-.G.-.-.G.-.-.G
P.-.-.-.-.-.-.-.-.-
-.-.-.G.-.-.-.-.PG.-
G.-.-.-.-.-.-.-.-.-
-.-.-.G.-.-.-.HP.-.P
-.-.-.-.-.-.-.-.-.A
PG.-.-.-.G.-.-.-.-.-
-.-.-.-.-.-.P.-.-.G
-.-.-.-.-.-.W.-.-.-
-.-.P.-.-.-.-.G.-.-