10 10 20 10
0 0 0 0 -1 -1 0 0 0 0
0 S 0 0 0 0 0 -1 0 0
0 0 -1 -1 -1 20 15 -1 0 0
0 0 0 0 -1 0 0 -1 0 0
0 0 -1 11 -1 0 G -1 0 0
1 0 -1 0 0 0 0 0 -1 0
0 0 4 9 -1 0 -1 8 -1 0
0 0 0 0 -1 0 0 0 0 0
0 0 0 0 -1 0 0 0 0 0
0 0 0 0 2 0 0 0 0 0
