10 10 20 7
-1 -1 -1 -1 -1 -1 -1 -1 -1 -1
-1 -1 -1 -1 0 -1 -1 -1 -1 -1
-1 -1 S1 0 0 0 0 S -1 -1
-1 -1 -1 -1 0 -1 -1 -1 -1 -1
-1 0 0 -1 0 -1 -1 0 0 G1
-1 0 -1 -1 0 -1 -1 0 -1 -1
-1 0 -1 -1 0 -1 -1 0 0 -1
-1 0 0 -1 0 -1 -1 -1 0 -1
-1 -1 0 0 0 0 0 -1 0 -1
-1 -1 -1 -1 G -1 0 0 0 -1