10 10 20 10
-1 -1 -1 -1 -1 -1 -1 -1 -1 -1
S 0 0 0 -1 0 0 0 0 0
-1 0 -1 0 0 0 -1 -1 -1 0
-1 0 -1 0 -1 0 0 0 0 0
-1 0 0 0 -1 0 -1 -1 -1 0
-1 0 -1 0 0 0 0 0 0 0
-1 0 -1 -1 0 -1 -1 -1 0 0
-1 0 0 0 0 0 0 0 0 0
-1 0 -1 -1 0 -1 -1 0 -1 G
-1 0 0 0 0 0 0 0 0 0