10 10 20 10
0 0 0 0 -1 -1 0 0 0 0
0 S 0 0 0 0 0 -1 0 -1
0 0 -1 -1 -1 0 0 -1 0 -1
0 0 0 0 -1 F5 F2 -1 0 0
0 0 -1 -1 -1 0 0 -1 0 0
1 0 -1 0 0 0 0 0 -1 0
0 0 F9 0 -1 3 -1 8 -1 0
0 0 0 0 -1 0 0 0 G 0
0 0 0 0 -1 0 0 0 0 0
0 0 0 0 -1 0 0 0 0 0